LEVEL 1
1
W,W,W,W,W,W,W,W,W,W,W,
W,W,S,S,R,S,S,S,S,S,W,
W,S,I,S,S,D,S,S,S,S,W,
W,S,S,S,S,S,S,S,S,S,W,
W,S,S,S, ,S,R,S,S,S,W,
W,S, ,S,S,S,S,S,E,S,W,
W,W,W,W,W,W,W,W,W,W,W,
